BBBBBBBBBBBBBBBBBBBBBBBB
BBBBBBBBBBBBBMBBBBBBBBBB
BBBBBBBBBOOOOOOBBBBBBBBB
BBBBBBBBBBBBBBBOBBBBBBBB
BBOBBBBPBBBBBBBBOBBBBBBB
BBOBBBBBBBBBBBBBOBBBBBBB
BBBOBBBBBBBBBBBBOBMBBBBB
BBBBBBBBBBBBBBBBBBBBBBBB
BBBBBBOOOOOOBBBBBBBBBBBB
BBBBBBBMBBBBBBBBBBBBBBBB
BBBBBBBBBBBOBBBBBBBBBBBB
BBBBBBBBBBBBOOOOBBBBBBBB
BBBBBBBBBBBBBBBBBBBBBBBB
BBBBBBBMBBBBBBBBBBBBBBBB
BBBBBBBBBBBBBBBBBBBBBBBB
BBBBBBBBBBBBBBBBBBBBBBBB
