BBBBBBBBBBBBBBBBBBBBBBBB
BBBBBBBBBBBBBBBBBBBBBBBB
BBBBBBBBBBBBBBMBBBBBBBBB
BBBBBBBBBBBBBBBBBBBBBBBB
BBBBBBBPBBBBBBBBBBBBBBBB
BBBBBBBBBBBBBBBBBBBBBBBB
BBBBBBBBBBBBBBBBBBMBBBBB
BBBBBBBBBBBBBBBBBBBBBBBB
OOOOOOOOOOOOBBBBBBBBBBBB
BBBBBBBBBBBBBBBBBBBBBBBB
BBBMBBBBBBBOBBBBBBBBBBBB
BBBBBBBBBBBBOOOOBBBBBBBB
BBBBBBBBBBBBBBBBBBBBBBBB
BBBBBBBBBBBBBBBBBBBBBBBB
BBBBBBBBBBBBBBMBBBBBBBBB
BBBBBBBBBBBBBBBBBBBBBBBB
