BBBBBBBBBBBBBBBBBBBBBBBB
BBBBBMBBBBBBBBBBBOBBBBBB
BBBBBBBBBBBBBBMBBOBBBBBB
BBBBBBBBBBBBBBBBOBBBBBBB
BBBBBBBMBBBBBBOOBBBBBBBB
BBBBBBBBBBBOOOOBBBBBBBBB
BBBBBBBBBBBBBBBBBBMBBBBB
BBBBBBBBBBBBBBBMBBBBBBBB
BBBBBBBBBBBBBBBBBBBBBBBB
BBBBBBBPBBBBBBBBBBBBBBBB
BBBMBBBBBBBBBBBBBBBBBBBB
BBBBBBBBBBBBBBBOBBBBBBBB
OOOOOOOOOOOOBBBBBBBBBBBB
BBBBBBBBBBBBBBBBBBBBBBBB
BBBBBBBBBBBBBBMBBBBBBBBB
BBBBBBBBBBBBBBBBBBBBBBBB
